11,21,20,30
1,2,3,4,5,6,7,8,9,10,31,32,33,34,35,36,37,38,39,40,41,42,43,44,45,46,47,48,49,50,51,52,53,54,55,56,57,58,59,60,61,62,63,64,65,66,67,68,69,70,71,72,73,74,75,76,77,78,79,80,81,82,83,84,85,86,87,88,89,90,91,92,93,94,95,96,97,98,99,100

11,20,51,60
1,2,3,4,5,6,7,8,9,10,61,62,63,64,65,66,67,68,69,70,71,72,73,74,75,76,77,78,79,80,81,82,83,84,85,86,87,88,89,90,91,92,93,94,95,96,97,98,99,100
15+1,16+2
1,2,100,10
3,13,23,24,25,99,55,56,65,54,45,91,92,82,81,71,61,72,83,93,94,95,96,97,98,99
20+1,40+2
1,2,100,10
3,13,23,24,25,26,27,28,38,48,99,55,56,65,54,45,91,92,82,81,71,61,72,83,93,94,95,96,97,98,99
20+3,40+2
1,2,100,10
3,13,23,24,25,26,27,28,38,48,99,55,56,65,54,45,91,92,82,81,71,61,72,83,93,94,95,96,97,98,99
20+4,40+2
1,91,10,100
2,12,13,14,16,26,36,32,8,18,38,39,40,48,49,50,59,60,30,20,34,43,52,81,82,84,54,71,96,86,67,56,78,79
3+1,42+2,99+3,70+4
11,20,51,60
1,2,3,4,5,6,7,8,9,10,61,62,63,64,65,66,67,68,69,70,71,72,73,74,75,76,77,78,79,80,81,82,83,84,85,86,87,88,89,90,91,92,93,94,95,96,97,98,99,100
35+4,26+5
1,91,10,100
2,12,13,14,16,26,36,32,8,18,38,39,40,48,49,50,59,60,30,20,34,43,52,81,82,84,54,71,96,86,67,56,78,79
3+4,42+5,99+3,70+4,45+4,75+1,91+2